########
#......#
#.@....#
#......#
#......#
#......#
#......#
########