########
##.....#
#.....##
#..#.#.#
#...@..#
#..#.#.#
#.....##
########